      NO          ./img/no.xpm                   
SO ./img/so.xpm



WE ./img/we.xpm


EA ./img/ea.xpm



F 255,255,255

C 0,0,0

 11111111
1000000001
1000000001
1000000001
1000N00001
1000000001
1000000001
1000000001
 11111111
