      NO          ./img/no.xpm                   
SO ./img/so.xpm



WE ./img/we.xpm


EA ./img/ea.xpm



F 255,255,255

C 0,0,0

 
11111
10101
10001
10N01
11111
