      NO          ./img/no.xpm                   
SO ./img/so.xpm



WE ./img/we.xpm


EA ./img/ea.xpm



F 255,255,255

C 0,0,0

1111111111111111111
1000000000000000001
1001100000000011001
1010000000000000101
101000000N000000101
1000000000000000001
1010000000000000101
1010000000000000101
1001100000000011001
1000000000000000001
1111111111111111111
