      NO          ./img/no.xpm                   
SO ./img/so.xpm



EA ./img/ea.xpm
WE ./img/we.xpm


F 255,255,255

C 0,0,0

 11111111111111111111
1000000000000000000001
1000100000000000000001
1000000000000000000001
1000E00100000000000001
 11111111111111111111
