      NO          ./img/no.xpm                   
SO ./img/so.xpm



WE ./img/we.xpm


EA ./img/ea.xpm



F 255,0,0

C 0,255,0
  
11111111111 11111111 1
11       11100000001
101111111000000N0011
101     10011111111
101  1 1001
101 10100001
101 1000001
 1   11111

