      NO          ./img/no.xpm
SO ./img/so.xpm
WE ./img/we.xpm
EA ./img/ea.xpm
F 255,0,0
C 0,255,0

 11111
100N001
 11111
