NO          ./img/no.xpm           
SO ./img/so.xpm
F 255,0,0

EA ./img/ea.xpm


WE ./img/we.xpm


C 0,0,255




1111111111111111111 1
100000000000N00000111
1101111111111111111
 101
 101111111111111111111
11000001000000000000001
11000000011111111111111
111111111