      NO          ./img/no.xpm                   
SO ./img/so.xpm



EA ./img/ea.xpm
WE ./img/we.xpm


F 255,255,255

C 0,0,0

 111      111 
10001    10001
10001111110001
10E00001000001
 1111100011111
     10101
 111110001
1000000001111111111111
10000000000000000000001
 111111111111111111111
