      NO          ./img/no.xpm                   
SO ./img/so.xpm



EA ./img/ea.xpm
WE ./img/we.xpm


F 255,255,255

C 0,0,0

11111    11111
10001    10001
10N01111110001
10000001000001
11111100011111
     10101
1111110001
10000000011111111111111
10000000000000000000001
1111111111111111111111
