      NO          ./img/no.xpm
SO ./img/so.xpm
WE ./img/we.xpm
EA ./img/ea.xpm
F 255,0,0
C 0,255,0
      11111111111111
 1111100000100100001
101100000W0000000001
10000000000000000001
11111111111111111111
